Wip

Mod directed by - You can't beat D
Contributers - Bjoon, thequagsir3, dom, Galrosa, Ziggy, Goofyguy,

Characters
Drat - You can't beat D
Mooncat - Redshell9
Wooper - thequagsir3
Yarn ball - beam
Marshmellow Sword - GalRosa & Bjoon
Ziggy - Ziggy

Redrawn assets:
Ghost sprites - You can't beat D


BOARDS
D's dimension - You can't beat D
Wooper's battle canyon - You can't beat D
Phighting crossroads - Bjoon
The Blue Hole
Goof's Tycoon town - Goofyguy
Goomba land - Ziggy

MUSIC
Midday showdown - Mario Circut (ost version) - Siivagunner
Subcomputer - Fly Octo Fly (short version) - Siivagunner
bgmenginepinch - Of Devious Machinations (Unused Version) - SiivaGunner
dwinmp3 - Act Clear (NTSC Version) - Siivagunner
finalfivebgm - Hello - Pizza OMFG
bgmstarlightpinch - Menu (OST VERSION) Smash 4 - SiivaGunner
endunlucky - Victory without a partner - Paper mario TTYD
bgmdominoruinspinch - Stuff It! - MEMODEMO
bgmdominoruins - Who YOU calling Pipsqueak!?!? - MEMODEMO
slowly yet surely - Robotnick rock - Iteachvader
bgmtoadsmidwaypinch - OVERTIME - PHIGHTING
bgmvdream - Memento - MEMODEMO
slowandsteady - Bossy crow - Billy hatcher
Sort - South Island (Lovers) - Sonic the fighters
Bigtrouble - Sonic vs knuckles - Sonic the fighters
Thatsall - The Drink (Cup) - Kobyshinobi
The pressure's on - The Runner - Pizza Tower
twinmp3 - Noise boss clear - Pizza tower
twinmp2 - Group minigame win - Super mario party
winwarboss - Victory (Mr.Game & Watch) - Siivagunner
winmpds - course clear (alternitve) - siivagunner
mbgmseriouscompetition - STYLISH STICKUP - Phighting
mbgmhappy - Cleaning up - Foamstars
bgmwbattlepinch - Dark skies - Castle crashers
mbgmgreatfear - Techock - Castle crashers
mbgmksnacks - The show - Castle crashers
howmany - Gold grab - Castle crashers
bgmwbattle - Goo-ladiators - Lights, camera, Pants!
bgmpirate5pinch - Hook, Line, & Chedder - Lights, camera, Pants!
mbgmwbunny - Jellyfish swish - Lights, camera, Pants!
mbgmwithoutcare - Flippin' Out! - Lights, camera, Pants!
mbgmwhatnow - SIMPSONS WORLD -
don't hurry - Luda Buster - MC TRASH
duelforprizes - Albuquerque - Weird Al
nervous tension - hard drive to munch you - Pizza tower
Miss 1-3 - Steel stings - Spongebob
mbgmcucumber - Quick minigame - Pac-man Party.
mbgmbis - Castle- RRThiel
bgmtoadsmidway - Rush hour - Phighting
bgmlatency - Miller Ball Breakers (OST Version) - Siivagunner
mbgmbreakers - Whoa I'm in Space Cuba - Siivagunner
bgmvdreampinch - Nine Jack - DOVA SYNDROME
modeselect - Freedom planet epilouge 
bgmlatencypinch - Splat 2 the Funk - SiivaGunner
mbgmwrobot - From Distrct to District - Minecraft legacy console
bgmgarage - Mobile Maneuvers - Minecraft legacy console
On your toes -  Time is of the Essence - Minecraft legacy console
nofright - A Tight Spot During Battle - Siivagunner
bgmpirate5 - Between the devil and the deep blue sea - Foamstars
bgmcavernpinch - A Star's best friend - Foamstars
mbgmtimetoduel - Agile Accelerando - Minecraft legacy console
mbgmlazyday - Dance of the blocks - Minecraft legacy console
mbgmheartpumping - Double Time - Minecraft legacy console
bgmtropicalislepinch - Angel of the Beach - Siivagunner
heart pumping - duel - It's up for debate - Siivagunner
how strange! - LOGIC&&TRICK - Siivagunner
bgmwaluigi - Mr. Monokuma's Swing Lesson - Siivagunner
bgmgaragenight - Madness - Siivagunner
bgmcavern - Cavern Club - Siivagunner
mbgmpumped - Get that turtle - Dave The Diver
mbgmjazzy - Classic Zone remix - Siivagunner
bgmpinballpinch - Special Stage! - Siivagunner
bgmtropicalisle - Marina Madness (Mania) - Siivagunner
bgmpinball - ZONE TIME - Persona 4 - Siivagunner
mbgmfaceoff - Final Battle with Red - Siivagunner
bgmhorrorpinch - Simpleflips' Nightmare - Scandre
goingforthecoins - Half a car type beat - Cordachi
gambling game - Gamblecore - Dem2006
bgmbowserlandpinch - Ultimate Koopa Clear - SilvaGunner
bgmbowserland - Ultimate Koopa - SilvaGunner
duel - Suspense - Pheonix Wright Ace attorney
bgmclockworknight - Coaster (Single mix) Siivagunner
bgmhorror - Horror Land - Siivagunner
bgmpuffypinch - Moonlight paradise- foamstars
bgmpuffy - On the bubble - Foamstars
bgmbeautypinch - MAD HEART - Mad Rat Dead
bgmbeauty - HEART'S Beat - Mad Rat Dead
bgmclockwork - MAD RAT, ALIVE? - Mad rat dead
bgmtreetoptemple - Bowling Steps - Mad Rat Dead
mbgmtwistnshake - DK Oatmeal - Zimbo
what to do - Cornered - UMVC3
bgmduela - m o r s h u w a v e - Memnicus
get into it - Cappuccino Crescendo - Phighting
bwinwarstage - TF2 Ending flare - Team fortress 2
badluck - Piracy is no Party! - Mario party Ds
tut5 - Let the Game Begin! - Siivagunner
yts5 - Shootin' Ropes - Friday night funkin
bgmsnowflake - Doin - HydroDalek
bgmsnowflakenight - ReDoin - JerryTerry
mbgmkteatime - The Blue Skies Yonder - Siivagunner
bgmspace - Space Land - Siivagunner
mbgmloudnsweet - Tough Enemy - Siivagunner
bgmpagoda - Magma Mine - Siivagunner
bgmtoy - Mario Party 9 Voices - Siivagunner
mbgmkgrass - A Jack-in-the-Box - Billy Hatcher
battle - Ultra Instinct theme - Dragon ball super
winmp5 - How did we do? - Omori
mbgmkeggcatch - Trance Music for Racing Game - MaestroBobbyCole Jazz
dream - Event Common - Pokken Tournament 
mbgmbean - Sentinel (E-Soldat's Theme) - Akatsuki Blitzkampf 
bouncing around - Green light ride - Team sonic Racing
bgmwigglersgardenpinch - Sylvan Radiance - Rivals of Aether 2
bgmtycoon - Life's Incredible Again - The Incredibles
bgmgala - Boiler City - Anton Blast
got it - Traning mode - Pokken Tournament
mbgmdarkness - Zepplin 2 - Buck bumble
mbgmwtag - paranoia - KENTENSHI
mbgmboss - Final destination (Delta) Siivagunner
results - Try again - Heaven studio
mbgmhurryhurry - It's pizza time - Pizza tower
bowser game - NO PARTY - Kenny L
mbgmbowser4 - NO PARTY - Kenny L
going somewhere - The Blue Skies Yonder (In game version) Siivagunner
winmp1t - Victory - Plants vs zombies 1
winmp4t - Superb! - Rhythm heaven
winmp3t - Superb! Rhythm heaven Fever
winmp3 - Challange failed - Heaven studio
winrpg - Challange win! - Heaven studio
winmp7 - Superb! - Heaven studio
winmp2 - Ok! - Heaven Studio
eventchancetime4 - default chance time + Somebody's getting fucked mashup (made by me)
bgmtowertreetop - Cottage house - Mad rat dead
bgmtowertreetopnight - Sprinting night - Mad rat dead
castleboss - SENSORY OVERLOAD - Phighting
oops - Feel the burn - Phighting
mbgmminikong - Moustache, Barrel, and Gorilla - DDR:Mario mix
bgmeternal - Madness - Chozo Warrior
bgmcastaway - Tropical Groove - Dave the Diver
bgmcastawaynight - Welcome to my bistro - Dave the Diver
mbgmlookingahead - Seahorse dash - Dave the diver
bgmrainbowcastle - Overworld - RRThiel & brycecarrington
mbgmslowly - Metal mario (eu version) SiivaGunner
